@ywywywxwdwxwywxyxwy
w.......wBw........x
x......w...w.......x
w.....h.....h......w
x....w.......w.....x
w...w.........w....w
dBwwwwwS....wwwwwwBd
w.aaaaw....Sx...c..w
x.....x.....y....c.x
w.....y.....w...c..w
x.....w.....x..c...x
w....px.....w.c....w
xaaaaaw..B..yc....px
wxyxwxwywdwywxwywxwx