@ywdwywxwywxwywxyxwy
wa..a.wxawxaa......x
xw.p........y.....sx
wwwwwwwwwiwwwwwwwwww
x..................x
w....p.............w
x..................x
w..................w
xs.................x
w..................w
xpwwww.........w...x
w...bw........wbwwpw
x.sw.w...s....xs...x
wxyxwxwywdwywxwywxwx
