@ywywddddddddywxyxwy
wS.......S.........x
x.......S..........x
wS.....S...........x
x....S.............x
wS.S...............w
xhxwxwxwxxxwxwxwxywx
wB.B.B.B.B.B.B.B.B.w
x..................x
w..................w
d..................d
w............E.....w
x.B.B.B.B.B.B.B.B.Bx
wxyxwxwywxwywxwywxwx
