@ywywddddddddywxyxwy
wEB.B.B............x
x.B.B.B........B...x
w.B.B.B.B....B.....x
x.B.B.B.B......B...x
w.B.B.B.B......B...w
x.B.B.B.B...B......x
w.B.B.B.......B....D
x.B.B.B.B.....B....x
w.B.B.B.B..........w
d.B.B.B.B.....B....w
w.B.B.B.B...B......w
x.cccccc.....B...xxx
wxyxwxwywxwywxwywxwx