@wwywwwywDwwywwwwyww
wwwwwwwwwBwwwwwwwwwy
wSSSSSSSS.SSSSSSSSSw
wwwwwwwwwcwwwwwwwwww
w.......yby........w
w.......yby........w
wE.......b.........w
w........b.........w
w.......yby........w
w.......yby........w
ywwwwwwwwcwwwwwwwwww
wSSSSSSSS.SSSSSSSSSw
wwwwwwwwwBwwwwwwwwww
wwwwwwwwwDwwwwwwwwwy