@wwywwwywywwywwwwyww
w.y.y.y.wE.w.y.y.y.y
wy.y.y.wS..cw.y.y.yw
w.y.y.wc....Sw.y.y.w
wy.y.wS......cw.y.yw
w.y.wc........Sw.y.w
wy.wS..........cw.yw
w.wc............Sw.w
wwwwwwwww..wwwwwwwww
wy...y........y...yw
y.y.y.y......y.y.y.w
wy.ya..y....y..ay.yw
w.ywy.B........B.wyw
wwwwwwwwwDDwwwwwwwwy