@ywywywxwdwxwywxyxwy
w..S....wBw...S....x
xwwwwwwww.wwwwwwwwwx
w.....h.....h......w
xx...w..SS...w.....x
w...w....S....w....w
dBwwwww..E..wwwwwwBd
w.aaaaw..w..x...c..w
xx....x..S..y....c.x
w..................w
x.....w..x..x......x
w....px..S..w.c....w
x........S.........x
wxyxwxwywdwywxwywxwx