@ywywywxwxwxwywxyxwy
wS.......S.........x
x.......S..........x
wS.....S...........d
x....S.............x
wS.S...............w
xdxwxwxwxxxwxwxwxywx
wB.B.B.B.B.B.B.B.B.w
x..................x
w..................w
x..................x
w............E.....w
x.B.B.B.B.B.B.B.B.Bx
wxyxwxwywxwywxwywxwx