@ywywxxxxxxxxywxyxwy
DS....xccccccx.....x
x.......S..........x
wSc....S...........x
x....S.............x
wS.S...............w
xhxwxwxwxxxwxwxwxywx
wB.B.B.B.B.B.B.B..cw
x......c...........x
w.................xw
d........a........Ex
w.................xw
xcB.B.B.B.B.B.B.B.Bx
wxyxwxwywxwywxwywxwx